9 9 9 9 9 9 0 9 0 9 0 9 9 9 9 9 9
9 8 7 8 7 8 7 9 8 9 7 8 7 8 7 8 9
9 7 8 7 8 7 8 9 7 9 8 7 8 7 8 7 9
9 8 7 9 9 9 9 9 6 9 9 9 9 9 7 8 9
9 7 8 9 7 7 7 7 6 7 7 7 7 9 8 7 9
9 8 7 9 7 8 8 8 5 8 8 8 7 9 7 8 9
9 7 8 9 7 8 4 4 4 4 4 8 7 9 8 7 9
9 8 7 9 7 8 4 3 3 3 4 8 7 9 7 8 9
9 7 8 9 7 8 4 3 2 3 4 8 7 9 8 7 9
9 8 7 9 7 8 4 4 4 4 4 8 7 9 7 8 9
9 7 8 9 7 8 8 8 5 8 8 8 7 9 8 7 9
9 8 7 9 7 7 7 7 6 7 7 7 7 9 7 8 9
9 7 8 7 8 7 8 9 6 9 8 7 8 7 8 7 9
9 8 7 8 7 8 7 0 9 0 7 8 7 8 7 8 9
9 0 0 0 9 0 9 0 9 0 9 0 9 0 0 0 9
0 0 0 0 0 0 0 0 0 0 0 0 0 0 0 0 0
0 9 0 9 0 9 0 9 0 9 0 9 0 9 0 9 0
0 0 0 0 0 0 0 0 0 0 0 0 0 0 0 0 0
0 0 0 9 0 9 0 0 0 0 0 9 0 9 0 0 0
1 1 1 1 0 0 0 0 0 0 0 0 0 1 1 1 1
1 1 1 1 1 0 9 9 9 9 9 0 1 1 1 1 1
1 1 1 1 1 1 0 0 0 0 0 1 1 1 1 1 1
2 2 2 2 2 2 2 0 0 0 2 2 2 2 2 2 2
2 2 2 2 2 2 2 2 0 2 2 2 2 2 2 2 2
6 6 6 6 6 6 6 0 0 0 6 6 6 6 6 6 6
6 6 6 6 6 6 0 0 0 0 6 6 6 6 6 6 6
6 6 6 6 6 0 0 0 0 0 0 6 6 6 6 6 6  