0 0 0 0 0 0 0 0 0 0 0 0 0 0 0 0 0
0 1 1 0 0 0 0 0 0 0 0 0 0 0 1 1 0
0 1 2 1 0 0 0 0 0 0 0 0 0 1 2 1 0
0 1 2 3 2 1 0 0 0 0 0 1 2 3 2 1 0
0 0 3 4 3 0 0 0 0 0 0 0 3 4 3 0 0
0 0 0 4 5 4 0 0 0 0 0 4 5 4 0 0 0
0 0 0 0 6 0 0 0 0 0 0 0 6 0 0 0 0
0 0 0 0 6 0 0 0 0 0 0 0 6 0 0 0 0
0 0 0 4 5 4 0 0 0 0 0 4 5 4 0 0 0
0 0 3 4 3 0 0 0 0 0 0 0 3 4 3 0 0
0 1 2 3 2 1 0 0 0 0 0 1 2 3 2 1 0
0 1 2 1 0 0 0 0 0 0 0 0 0 1 2 1 0
0 1 1 0 0 0 0 0 0 0 0 0 0 0 1 1 0
0 0 0 0 0 0 0 0 0 0 0 0 0 0 0 0 0
0 0 0 0 0 0 0 0 0 0 0 0 0 0 0 0 0