0 0 0 0 0 0 0 0 0 0 0 0 0 0 0 0 0
0 0 0 0 0 0 0 0 0 0 0 0 0 0 0 0 0
0 0 0 1 2 1 0 0 0 0 0 0 1 2 1 0 0
0 0 0 0 1 2 0 0 0 0 0 0 2 1 0 0 0
0 0 0 0 0 0 3 3 0 3 3 0 0 0 0 0 0
1 2 3 0 0 4 5 4 0 4 5 4 0 0 3 2 1
0 1 2 0 4 5 7 5 0 5 7 5 4 0 2 1 0
0 0 0 0 4 5 7 5 0 5 7 5 4 0 0 0 0
0 1 2 0 4 5 7 5 0 5 7 5 4 0 2 1 0
1 2 3 0 0 4 5 4 0 4 5 4 0 0 3 2 1
0 0 0 0 0 0 3 3 0 3 3 0 0 0 0 0 0
0 0 0 0 1 2 0 0 0 0 0 0 2 1 0 0 0
0 0 0 1 2 1 0 0 0 0 0 0 1 2 1 0 0
0 0 0 0 0 0 0 0 0 0 0 0 0 0 0 0 0
0 0 0 0 0 0 0 0 0 0 0 0 0 0 0 0 0