0 0 0 0 0 0 0 0 0 0 0 0 0 0 0 0 0
0 0 0 0 0 0 0 0 0 0 0 0 0 0 0 0 0
0 2 2 0 0 0 3 3 3 3 3 0 0 0 2 2 0
0 2 3 2 0 0 3 4 4 4 3 0 0 2 3 2 0
0 2 3 2 0 0 10 4 5 4 10 0 0 2 3 2 0
0 1 3 1 0 0 0 0 0 0 0 0 0 1 3 1 0
0 1 1 1 0 0 0 0 0 0 0 0 0 1 1 1 0
0 0 0 10 10 1 1 1 1 1 1 1 10 10 0 0 0
0 0 0 0 0 1 2 2 2 2 2 1 0 0 0 0 0
0 0 0 0 0 1 1 1 1 1 1 1 0 0 0 0 0
0 0 0 0 0 10 0 0 0 0 10 0 0 0 0 0
0 0 0 0 0 0 0 0 0 0 0 0 0 0 0 0 0
0 0 0 0 0 0 0 0 0 0 0 0 0 0 0 0 0
0 0 0 0 0 0 0 0 0 0 0 0 0 0 0 0 0
0 0 0 0 0 0 0 0 0 0 0 0 0 0 0 0 0