8 7 0 0 0 0 0 0 0 0 0 0 0 0 0 7 8
7 8 7 0 0 0 0 0 0 0 0 0 0 0 7 8 7
0 7 8 7 9 9 9 9 9 9 9 9 9 7 8 7 0
0 0 7 9 8 7 6 5 5 5 6 7 8 9 7 0 0
0 0 9 7 8 7 6 5 4 5 6 7 8 7 9 0 0
0 0 9 8 7 8 7 6 5 6 7 8 7 8 9 0 0
0 0 0 9 8 7 8 7 6 7 8 7 8 9 0 0 0
0 0 0 0 9 8 7 8 7 8 7 8 9 0 0 0 0
0 0 0 0 0 9 9 9 9 9 9 9 0 0 0 0 0
1 2 3 4 5 6 0 0 0 0 0 6 5 4 3 2 1
0 1 2 3 4 5 0 0 0 0 0 5 4 3 2 1 0
0 0 1 2 3 4 0 0 0 0 0 4 3 2 1 0 0
0 0 0 1 2 3 0 0 0 0 0 3 2 1 0 0 0
0 0 0 0 1 2 0 0 0 0 0 2 1 0 0 0 0