0 0 0 0 0 0 0 0 0 0 0 0 0 0 0 0 0
0 0 0 0 0 0 9 8 7 8 9 0 0 0 0 0 0
0 0 0 0 0 9 7 6 5 6 7 9 0 0 0 0 0
0 0 0 0 9 8 6 5 4 5 6 8 9 0 0 0 0
0 0 0 0 9 4 5 4 3 4 5 4 9 0 0 0 0
0 0 0 0 0 9 6 5 4 5 6 9 0 0 0 0 0
0 0 0 0 0 0 9 8 7 8 9 0 0 0 0 0 0
0 0 0 0 0 0 0 0 0 0 0 0 0 0 0 0 0
0 0 0 0 0 0 0 0 0 0 0 0 0 0 0 0 0
0 6 6 6 6 6 6 6 6 6 6 6 6 6 6 6 0
0 9 8 7 8 7 8 7 8 7 8 7 8 7 8 9 0
0 9 7 8 7 8 7 8 7 8 7 8 7 8 7 9 0
0 9 8 7 8 7 8 7 8 7 8 7 8 7 8 9 0
0 9 2 2 2 2 2 2 2 2 2 2 2 2 2 9 0
0 0 0 0 0 0 0 0 0 0 0 0 0 0 0 0 0
0 0 0 9 0 0 0 0 0 0 0 0 0 9 0 0 0
0 0 9 8 7 0 0 0 0 0 0 0 7 8 9 0 0
0 0 9 7 8 7 0 0 0 0 0 7 8 7 9 0 0
0 0 0 9 8 7 0 0 0 0 0 7 8 9 0 0 0
0 0 0 0 9 8 7 0 0 0 7 8 9 0 0 0 0
0 0 0 0 0 9 8 7 0 7 8 9 0 0 0 0 0
0 0 0 0 0 0 9 9 9 9 9 0 0 0 0 0 0
0 0 0 0 0 0 0 0 0 0 0 0 0 0 0 0 0
0 0 4 4 0 0 0 0 0 0 0 0 0 4 4 0 0
0 3 3 3 3 0 0 0 0 0 0 0 3 3 3 3 0
0 2 2 2 2 2 0 0 0 0 0 2 2 2 2 2 0
0 1 1 1 1 1 1 0 0 0 1 1 1 1 1 1 0
0 0 0 0 0 0 0 0 0 0 0 0 0 0 0 0 0
0 0 0 0 0 0 0 1 0 1 0 0 0 0 0 0 0
0 0 0 0 0 0 0 1 1 1 0 0 0 0 0 0 0